nev	style
Abbey, Edwin Austin	Illustration, Painting, Oil, Pastel, Ink, USA, 19th Century
Abts, Tomma	Illustration, Painting, Oil, Acrylic, Pattern, Germany
Achenbach, Andreas	Painting, Oil, Landscape, Marine, Germany, 19th Century
Ackroyd, Norman	Aquatint, Landscape, B&W, UK
Adams, Ansel	Photography, Landscape, B&W, USA
Adams, Art (Arthur)	Illustration, Comic, DC Comics, Marvel, Cover Art, B&W, USA
Adams, Neal	Illustration, Comic, DC Comics, Marvel, Cover Art, USA
Adamski, Josh	Photography, Photograph Manipulation, Impressionism, Israel
Adnan, Etel	Painting, Oil, Expressionism, Abstract, Lebanese, American
Adolfsson, Mattias	Illustration, Watercolor, Ink, Sweden
Aenami, Alena	Illustration, Concept Art, Landscape, Ukraine
Aertsen, Pieter	Painting, Oil, Still Life, Genre Painting, Renaissance, Netherlands, 16th Century
Afremov, Leonid	Painting, Belarus
Afshar, Petros	Illustration, UK
Agam, Yaacov	Painting, Sculpture, Installation, Pattern, Concretism, Israel
Agar, Eileen	Painting, Oil, Photography, Abstract, Surrealism, UK
Aivazovsky, Ivan	Painting, Oil, Marine, Crimea, 19th Century
Aja, David	Illustration, Comic, Cover Art, Spain
Albi, Alessio	Photography, Portrait, Italy
Albuquerque, Rafael	Comic, DC Comics, Brazil
Aldridge, Miles	Photography, Portrait, UK
Alizadeh, Shahab	Illustration, Concept Art, Austria
Allingham, Helen	Illustration, Watercolor, Ink, Children's Book, UK, 19th Century
Allori, Alessandro	Painting, Oil, Portrait, Mythology, Renaissance, Italy, 16th Century
Allred, Mike	Comic, DC Comics, USA
Altdorfer, Albrecht	Painting, Oil, Engraving, Germany, 16th Century
Amano, Yoshitaka	Illustration, Character Design, Game Art, Japan
Amaral, Tarsila do	Painting, Oil, Brazil
Amiet, Cuno	Painting, Oil, Landscape, Portrait, Expressionism, Switzerland
Amorsolo, Fernando	Painting, Oil, Portrait, Landscape, Philippines
Anacleto, Jay	Comic, DC Comics, Marvel, Cover Art, USA
Ancher, Anna	Painting, Oil, Portrait, Denmark, 19th Century
Anderson, Richard	Illustration, Concept Art, Game Art, UK
Anderson, Wes	Movie Director, USA
Andreev, Alex	Illustration, Concept Art, Russia
Andrews, Esao	Painting, Oil, Surrealism, USA
Annigoni, Pietro	Painting, Oil, Portrait, Italy
Ansin, Martin	Illustration, Poster, B&W, Uruguay
Aoshima, Chiho	Illustration, Superflat, Japan
Appel, Karel	Painting, Oil, Acrylic, Abstract, Netherlands
Apterus, Sabbas (Peter Polach)	Illustration, Concept Art, Fantasy, Horror, Slovakia
Archipenko, Alexander	Sculpture, Painting, Ink, Oil, Gouache, Cubism, Ukraine, USA
Arcimboldo, Giuseppe	Painting, Oil, Still Life, Botanical, Italy, 16th Century
Ardon, Mordecai	Painting, Oil, Poland, Israel
Armstrong, Rolf	Painting, Pastel, Portrait, Pin-Ups, Cover Art, Nudity, USA
Arnegger, Alois	Painting, Oil, Landscape, Austria
Arntzenius, Floris	Illustration, Painting, Oil, Watercolor, Portrait, Landscape, Netherlands, 19th Century
Arrivabene, Agostino	Illustration, Painting, Oil, Ink, Surrealism, Italy
Artgerm (Stanley Lau)	Illustration, Concept Art, Marvel, DC Comics
Asencio, Henry	Painting, Oil, USA
Ast, Balthasar van der	Painting, Still Life, Oil, Botanical, 17th Century
Astrup, Nikolai	Painting, Woodcut, Norway
Atget, Eugène	Photography, Portrait, Landscape, B&W, France, 19th Century
Audubon, John James	Illustration, Ornithology, Haiti, 19th Century
Auerbach, Frank	Painting, Oil, Portrait, UK
Avedon, Richard	Photography, Portrait, B&W, USA
Bachalo, Chris	Comic, DC Comics, Marvel, B&W, Canada
Bachelier, Anne	Illustration, Painting, Watercolor, Surrealism, France
Bagshaw, Tom	Painting, Portrait, UK
Bailly, Alice	Painting, Oil, Tempera, Portrait, Cubism, Switzerland
Bak, Karol	Illustration, Painting, Portrait, Poland
Bakshi, Ralph	Movie Director, Animation, Comic, Palestine, USA
Balaskas, Christopher	Concept Art, Character Design, Game Art, USA
Balivet, Emily	Painting, Oil, Portrait, Mythology, USA
Balke, Peder	Painting, Landscape, Oil, Norway, 19th Century
Bana, Benedick	Concept Art, Sci-Fi, Philippines
Barbier, George	Illustration, Painting, France
Barker, Clive	Author, Painting, Horror, Fantasy, UK
Barlowe, Wayne	Illustration, Painting, Concept Art, Fantasy, Sci-Fi, Horror, USA
Barnes, Ernie	Painting, Oil, Acrylic, Portrait, USA
Barnet, Will	Illustration, Painting, Oil, Watercolor, Portrait, USA
Barrett, Angela	Illustration, Watercolor, Gouache, Children's Book, UK
Barson, Paul	Photography, Botanical, USA
Bartlett, Bo	Painting, Oil, Portrait, Realism, USA
Baugh, Casey	Painting, Oil, Portrait, USA
Beal, Gifford	Painting, Watercolor, Landscape, USA
Beardsley, Aubrey	Illustration, B&W, UK
Beatrix Potter	Illustration, Watercolor, Children's Book, UK
Beeple (Mike Winkelmann)	Concept Art, Sci-Fi, USA
Beksiński, Zdzisław	Painting, Horror, Poland
Bellmer, Hans	Photography, Visual Arts, Germany
Bellows, George Wesley	Painting, Oil, Portrait, USA
Bemelmans, Ludwig	Illustration, Watercolor, Gouache, Austria, USA
Benois, Alexandre	Painting, Oil, Watercolor, Russia
Bergey, Earle K.	Illustration, Painting, Cover Art, Pin-Ups, USA
Berkey, John	Painting, Sci-Fi, Star Wars, USA
Bernini, Gian Lorenzo	Sculpture, Marble, Painting, Baroque, Italy, 17th Century
Beskow, Elsa	Illustration, Watercolor, Children's Book, Cover Art, Sweden
Bidgood, James	Movie Director, Photography, USA
Biernacki, Szymon	Illustration, Animation, Character Design, Spain
Bierstadt, Albert	Painting, Oil, Landscape, USA, 19th Century
Biggers, John Thomas	Painting, Oil, Acrylic, Portrait, USA
Bilal, Enki	Illustration, Comic, France
Bilibin, Ivan	Illustration, Painting, Watercolor, Ink, Gouache, Art Nouveau, Russia
Billy, Butcher	Illustration, Painting, Cover Art, Brazil
Binkley, Ed	Illustration, Concept Art, Fantasy, Game Art, USA
Bischoff, Elmer	Painting, Oil, Acrylic, Portrait, USA
Bisley, Simon	Comic, UK
Bissell, Robert	Painting, Oil, UK
Blair, Mary	Illustration, Disney, USA
Blanchard, Antoine	Painting, Oil, Cityscape, France
Blanche, John	Illustration, Fantasy, Sci-Fi, Warhammer, UK
Blandin, Tim	Concept Art, Sci-Fi
Blevins, Neil	Illustration, Concept Art, Sci-Fi, Game Art, USA
Boccioni, Umberto	Painting, Oil, Portrait, Futurism, Italy
Bolland, Brian	Illustration, Comic, DC Comics, Cover Art, UK
Bonestell, Chesley	Illustration, Painting, Oil, Gouache, Sci-Fi, USA
Bonhomme, Olivier	Illustration, France
Bonnard, Pierre	Painting, Oil, Portrait, Landscape, Post-Impressionism, France, 19th Century
Booth, Franklin	Illustration, Watercolor, Ink, USA
Borgeaud, Marius	Painting, Oil, Portrait, Switzerland, France, 19th Century
Bors, Matt	Illustration, Comic, USA
Bosch, Hieronymus	Painting, Oil, Netherlands, 15th Century
Bosma, Sam	Illustration, Comic, Graphic Novel, Cover Art, USA
Bosschaert, Ambrosius (the Elder)	Painting, Oil, Still Life, Botanical, Flemish, 17th Century
Bosschart, Johfra	Illustration, Painting, Surrealism, Netherlands
Botero	Painting, Oil, Colombia
Botticelli, Sandro	Painting, Oil, Italy, 15th Century
Boucher, François	Painting, Illustration, Engraving, Portrait, Rococo, France, 18th Century
Bowater, Charlie	Illustration, Concept Art, Portrait, UK
Bowers, David Michael	Illustration, Painting, Oil, Cover Art, Surrealism, USA
Bowling, Frank	Painting, Acrylic, Expressionism, UK
Boys, Thomas Shotter	Painting, Watercolor, Cityscape, UK
Bradley, Noah	Concept Art, DnD, MTG, USA
Bramley, Frank	Painting, Oil, UK, 19th Century
Brauner, Victor	Painting, Oil, Surrealism, Romania,
Bridgman, George B.	Painting, Landscape, Portrait, Canada
Briggs, Austin	Illustration, Comic, Cartoon, USA
Britto, Romero	Painting, Acrylic, Pop-Art, Brazil
Brogan, Glen	Illustration, USA
Brom, Gerald	Illustration, Fantasy, Gothic, Horror, USA
Burne-Jones, Edward	Painting, Oil, Watercolor, Gouache, Stained Glass, Portrait, Mythology, UK, 19th Century
Burns, Jim	Illustration, Painting, Acrylic, Sci-Fi, Cover Art, UK
Bussière, Gaston	Illustration, Painting, Oil, Portrait, France, 19th Century
Böcklin, Arnold	Painting, Oil, Portrait, Landscape, Symbolism, Switzerland, 19th Century
Cadell, Francis	Painting, Oil, Portrait, Scotland, UK
Cadmus, Paul	Painting, Oil, Tempera, Portrait, Nudity, USA
Caldwell, Clyde	Illustration, Painting, Oil, Acrylic, Fantasy, Cover Art, USA
Calleri, Fred	Painting, Oil, Portrait, USA
Camoin, Charles	Painting, Oil, Portrait, France
Campbell Cooper, Colin	Painting, Oil, Watercolor, Cityscape, USA
Campion, Pascal	Illustration, Animation, France
Caniff, Milton	Comic, B&W, USA
Carpio, Pablo	Character Design, Concept Art, Game Art, Spain
Carson, Michael	Painting, Oil, Portrait, USA
Caruso, Santiago	Illustration, Concept Art, Cover Art, Gothic, Horror, Symbolism, Surrealism, Argentina
Cassegrain, Didier	Illustration, Comic, France
Casson, Alfred Joseph	Painting, Landscape, Oil, Canada
Catherall, Paul	Illustration, Linocut, Print, Cover Art, Poster, UK
Cearley, Clint	Illustration, Blizzard, DnD, MTG, USA
Cecile, Agnes (Silvia Pelissero)	Illustration, Painting, Watercolor, Portrait, Italy
Chagall, Marc	Painting, Cubism, Expressionism, Belarus, France
Chamberlain, John	Sculpture, Pop-Art, USA
Chardin, Jean Siméon	Painting, Oil, Still Life, Portrait, 18th Century, France
Charest, Travis	Illustration, Comic, Ink, DC Comics, Canada
Chavannes, Pierre Puvis de	Painting, Oil, Symbolism, France, 19th Century
Cheng, Hsiao-Ron	Illustration, Portrait, Taiwan
Cheng, Yanjun	Illustration, Portrait
Chermayeff, Ivan	Illustration, Graphic Design, Logo, UK, USA
Cheval, Michael	Painting, Oil, Portrait, Surrealism, Russia, USA
Chevrier, Sandra	Painting, Acrylic, Portrait, Canada
Chihuly, Dale	Sculpture, Glas, USA
Cho, Frank	Illustration, Comic, DC Comics, Marvel, Cover Art, South Korea, USA
Christensen, James C.	Illustration, Painting, Oil, Mythology, Fantasy, USA
Cimabue (Cenni di Pepo)	Painting, Tempera, Portrait, Mythology, Italy, 13th Century
Ciurlionis, Mikalojus	Painting, Symbolism, Lithuania, 19th Century
Clarke, Harry	Illustration, Stained Glass, Ireland
Clive, Henry	Illustration, Cover Art, Portrait, Australia, USA
Cloonan, Becky	Comic, DC Comics, B&W, USA
Cobb, Ron	Illustration, Character Design, Concept Art, USA
Coburn, Alvin Langdon	Photography, Portrait, B&W, USA
Cold, Chris	Illustration, Concept Art, Game Art, Spain
Conder, Charles Edward	Painting, Oil, Landscape, Portrait, Impressionism, UK, 19th Century
Condo, George	Painting, Oil, Portrait, Cubism, USA
Constable, John	Painting, Oil, Landscape, UK, 18th Century
Coomber, Yvonne	Painting, Oil, Botanical, UK
Corben, Richard	Comic, DC Comics, Marvel, Horror, USA
Corfield, Paul	Painting, Landscape, UK
Corinth, Lovis	Painting, Oil, Portrait, Impressionism, Expressionism, Germany, 19th Century
Corot, Jean-Baptiste Camille	Painting, Oil, Landscape, Realism, France, 18th Century
Coss, Shawn	Illustration, USA
Cossa, Francesco del	Painting, Oil, Portrait, Mythology, Italy, 15th Century
Crane, Walter	Illustration, Painting, Art Nouveau, Children's Book, UK, 19th Century
Crepax, Guido	Illustration, Comic, Graphic Novel, Cover Art, Nudity, B&W, Italy
Crewdson, Gregory	Photography, Portrait, Realism, USA
Criswell, Debbie	Painting, USA
Crosby, Njideka Akunyili	Painting, Oil, Acrylic, Pastels, Collage, Portrait, Nigeria, USA
Cross, Henri Edmond	Painting, Oil, Watercolor, Landscape, Pointillism, France, 19th Century
Crécy, Nicolas de	Comic, Disney, France
Currin, John	Painting, Oil, Portrait, Nudity, USA
Cézanne, Paul	Painting, Oil, Landscape, Portrait, Cubism, Impressionism, France, 19th Century
Da Vinci, Leonardo	Painting, Oil, Portrait, Landscape, Sculpture, Italy, 15th Century
DaLuz, Steven	Painting, USA
Daeni, Pino	Illustration, Painting, Portrait, Cover Art, Italy
Dahl-Wolfe, Louise	Photography, Fashion, USA
Dalrymple, Farel	Illustration, Watercolor, Author, Comic, Graphic Novel, DC Comics, Marvel, Cover Art, USA
Darger, Henry	Illstration, Watercolor, Author, USA
Darrow, Geof	Illustration, Comic, Graphic Novel, Cover Art, USA
Daumier, Honoré	Illustration, Cartoon, Lithography, Ink, France, 19th Century
David, Jacques-Louis	Painting, Oil, Portrait, Neoclassicism, France, 18th Century
Davis, Jack	Comic, Mad Magazine, USA
Davis, Marc	Illustration, Animation, Character Design, Disney
Davison, Craig	Illustration, Comic, UK
De Morgan, Evelyn	Painting, Oil, Symbolism, Romanticism, UK, 19th Century
De Ro, Jonas	Illustration, Concept Art, Belgium
DeConnick, Kelly Sue	Comic, DC Comics, Marvel, USA
DeForge, Michael	Illustration, Comic, Graphic Novel, Canada
Deakin, Edwin	Painting, Oil, Architecture, Landscape, Still Life, UK, USA, 19th Century
Dean, Roger	Illustration, Painting, Acrylic, Fantasy, Cover Art, UK
Degas, Edgar	Painting, Oil, Portrait, Impressionism, France, 19th Century
Delaunay, Robert Victor Félix	Painting, Oil, Watercolor, Pastel, Cubism, Abstract, France
Delort, Nicolas	Illustration, Fantasy, MTG, Game Art, B&W, Canada, France
Delvaux, Paul	Painting, Oil, Ink, Watercolor, Surrealism, Belgium
Delville, Jean	Painting, Symbolism, Belgium, 19th Century
Delvoye, Wim	Concept Art, Belgium
Denis, Maurice	Painting, Symbolism, France, 19th Century
Denning, Guy	Painting, Oil, Street Art, B&W, UK
Deodato, Mike	Comic, DC Comics, Marvel, B&W, Brazil
Detmold, Charles Maurice	Illustration, Watercolor, Ink, UK
Di Fate, Vincent	Illustration, Painting, Fantasy, Sci-Fi, Cover Art, USA
Diefenbach, Karl Wilhelm	Painting, Oil, Portrait, Landscape, Symbolism, Germany, 19th Century
Dillon, Diane	Illustration, Children's Book, Cover Art, USA
Ditko, Steve	Comic, Marvel, USA
Dittmann, Anna	Illustration, Portrait, DC Comics, USA
Doré, Gustave	Illustration, Painting, B&W, France, 19th Century
Douglas, Emory	Illustration, Graphic Design, Print, Cover Art, Poster, USA
Downton, David	Illustration, Fashion, Portrait, UK
Doyle, Tim	Illustration, USA
Driskell, David C.	Painting, Acrylic, Collage, USA
Druillet, Philippe	Illustration, Comic, France
Dubuffet, Jean	Painting, France
Duchamp-Villon, Raymond	Sculpture, Drawing, Ink, France
Duddle, Jonny	Author, Illustration, Children's Book, UK
Dulac, Edmund	Illustration, Watercolor, Ink, France
Durand, Asher Brown	Painting, Oil, Landscape, USA, 19th Century
Dyer, Chris	Painting, Canada
Dürer, Albrecht	Illustration, Engraving, B&W, Germany, 15th Century
Eakins, Thomas	Painting, Oil, Landscape, Portrait, Realism, USA, 19th Century
Earle, Eyvind	Illustration, Painting, Concept Art, Fantasy, Disney, USA
Earles, Amy	Illustration, Painting, Oil, Gouache, USA
Easley, Jeff	Comic, Painting, Oil, Fantasy, Marvel, USA
Eaton, Tristan	Illustration, Street Art, Portrait, USA
Edlin, Tyler	Character Design, Concept Art, Game Art, Fantasy, USA
Edmiston, Jason	Illustration, Painting, Acrylic, Canada
Eggleston, William	Photography, USA
Eggleton, Bob	Illustration, Painting, Fantasy, Sci-Fi, Horror, Cover Art, MTG, USA
Eisner, Will	Comic, USA
El Greco (Domínikos Theotokópoulos)	Painting, Oil, Portrait, Mythology, Greece, 16th Century
El Huervo (Niklas Åkerblad)	Illustration, Painting, Oil, Watercolor, Game Art, Cover Art, Sweden
Ellis, Dean	Illustration, Painting, Sci-Fi, Cover Art, USA
Elsheimer, Adam	Painting, Oil, Portrait, Landscape, Mythology, Germany, 16th Century
Elson, Peter	Illustration, Painting, Sci-Fi, Cover Art, UK
Elvgren, Gil	Illustration, Pin-Ups, USA
Emshwiller, Ed	Illustration, Sci-Fi, USA
Eng, Kilian	Illustration, Sweden
Enjolras, Delphin	Painting, Oil, Pastel, Portrait, Nudity, France
Erni, Hans	Painting, Sculpture, Switzerland
Ernst, Maximilian Maria	Painting, Oil, Dada, Surrealism, Germany, France
Erté (Romain de Tirtoff)	Illustration, Fashion, Cover Art, Art Deco, Russia, France
Escher, Maurits Cornelis	Illustration, Surrealism, B&W, Netherlands
Eversen, Adrianus	Painting, Watercolor, Architecture, Netherlands, 19th Century
Fabry, Glenn	Illustration, Painting, Comic, Acrylic, Gouache, Ink, Cover Art, UK
Fadeev, Anton	Illustration, Concept Art, Fantasy, Russia
Fairey, Shepard	Illustration, Street Art, Portrait, USA
Fairhurst, Andy	Illustration, Character Design, Concept Art, Australia
Falter, John Philip	Illustration, Painting, Oil, Cover Art, USA
Fang, Lijun	Painting, Oil, Surrealism, China
Fantin-Latour, Henri	Painting, Oil, Still Life, Portrait, Botanical, 19th Century, France
Fegredo, Duncan	Comic, UK
Feininger, Lyonel	Painting, Landscape, Expressionism, USA
Ferez, Andrew	Illustration, Fantasy, Russia
Ferri, Roberto	Painting, Oil, Portrait, Nudity, Mythology, Italy
Ferriss, Hugh	Illustration, Architecture, Cityscape, B&W, USA, 19th Century
Finlay, Virgil	Illustration, Fantasy, Sci-Fi, B&W, USA
Finnstark, Anato	Illustration, Concept Art, MTG, France
Fischer, Paul Gustav	Painting, Oil, Landscape, Portrait, Denmark
Fischinger, Oskar	Movie Director, Animation, Abstract, Germany
Flavin, Dan	Light Installation, Minimalism, USA
Flinck, Govert	Painting, Oil, Portrait, Netherlands, 17th Century
Flint, Alex Russell	Painting, Oil, Portrait, UK
Foksowicz, Piotr	Illustration, Concept Art, Game Art, Fantasy, Poland
Forbes, Stanhope	Painting, Oil, Landscape, Ireland, 19th Century
Fortescue-Brickdale, Eleanor	Painting, Illustration, UK
Foss, Chris	Illustration, Painting, Sci-Fi, Guernsey
Foster, Hal	Illustration, Comic, Canada
Foster, Jon	Illustration, Comic, Cover Art, Game Art, MTG, USA
Fra Angelico	Painting, Oil, Tempera, Portrait, Mythology, Italy, 15th Century
Fraction, Matt	Comic, Marvel, USA
Fragonard, Jean-Honoré	Painting, Oil, Portrait, Rococo, France, 18th Century
Francavilla, Francesco	Comic, Graphic Novel, DC Comics, Marvel, Cover Art, Italy
Francesca, Piero della	Painting, Oil, Italy, 15th Century
Frank, Lisa	Illustration, Rainbow, USA
Frazetta, Frank	Illustration, Fantasy, Sci-Fi, USA
Friedrich, Caspar David	Painting, Oil, Landscape, Romanticism, Germany, 19th Century
Friel, Chris	Photography, Landscape, B&W, UK
Froud, Brian	Illustration, Fantasy, Concept Art, Jim Henson, UK
Fuchs, Ando	Photography, Portrait, Landscape, B&W, Italy
Fujita, Goro	Illustration, Animation, Character Design, Japan, USA
Gallagher, Ellen	Painting, Gouache, Watercolor, Collage, Portrait, USA
Gammell, Stephen	Illustration, Watercolor, Ink, Horror, USA
Gangloff, Hope	Painting, Portrait, USA
Gauguin, Paul	Painting, Oil, Portrait, France, 19th Century
Geddes, Jeremy	Illustration, Painting, Oil, Covert Art, Author, New Zealand
Gentileschi, Artemisia	Painting, Oil, Portrait, Baroque, Italy, 17th Century
Georgi, Edwin	Painting, Oil, Gouache, Watercolor, Portrait, Pin-Ups, USA
Gerard, Justin	Illustration, Fantasy, USA
Gerhartz, Daniel F.	Painting, Oil, Portrait, USA
Ghailan, Atey	Illustration, Concept Art, Game Art, USA
Ghenie, Adrian	Painting, Oil, Romania
Ghirlandaio, Domenico	Painting, Oil, Portrait, Mythology, Italy, 15th Century
Giancola, Donato	Illustration, Concept Art, Sci-Fi, Fantasy, Game Art, MTG, USA
Gibbons, Dave	Illustration, Author, Comic, DC Comics, Marvel, Graphic Novel, Watchmen, UK
Gibson, Charles Dana	Illustration, Ink, Cartoon, USA
Gibson, Ralph	Photography, Portrait, USA
Giger, Hans Rudolf	Painting, Oil, Concept Art, Cover Art, Horror, Switzerland
Gilleard, James	Illustration, Animation, Concept Art, UK
Gilliam, Sam	Painting, Visual Arts, USA
Glackens, William James	Illustration, Painting, USA, 19th Century
Glaser, Milton	Illustration, Flat Style, USA
Goble, Warwick	Illustration, Watercolor, Ink, Children's Book, UK, 19th Century
Gogos, Basil	Illustrator, Painting, Oil, Acrylic, Gouache, Portrait, Cover Art, Horror, Egypt, USA
Goldin, Nan	Photography, Portrait, USA
Gonsalves, Rob	Painting, Oil, Acrylic, Surrealism, Canada
Gonzalez, Josan (Death Burger)	Illustration, Cocos Islands
Goodwin, Albert	Painting, Oil, Watercolor, Landscape, UK, 19th Century
Gordin, Misha	Photography, Concept Art, B&W, Latvia
Gores, Derek	Collage, USA
Gottardo, Alessandro (Shout)	Illustration, Flat Style, Italy
Grandville, J.J.	Illustration, Painting, Lithography, France, 19th Century
Grant, Duncan	Painting, Oil, Portrait, Scotland, UK
Grasset, Eugène	Illustration, Lithography, Art Nouveau, Switzerland, 19th Century
Greasley, Laurie	Illustration, Concept Art, Scotland, UK
Greenaway, Kate	Illustration, Watercolor, Children's Book, UK, 19th Century
Grelle, Martin	Painting, USA
Grey, Alex	Painting, Oil, Psychedelic Art, USA
Gric, Peter	Illustration, Painting, Horror, Czech Republic
Griffiths, Carne	Painting, Ink, Portrait, UK
Grimly, Gris	Author, Illustration, Children's Book, USA
Grimmer, Jordan	Concept Art, Game Art, UK
Grimshaw, John Atkinson	Painting, Oil, Cityscape, UK, 19th Century
Gross, Alex	Painting, Oil, Portrait, USA
Guangjian, Huang	Illustration, Concept Art, Game Art, China
Guay, Rebecca	Illustration, Fantasy, MTG, USA
Guay, Sam	Painting, Watercolor, Fantasy, MTG, USA
Guillaumin, Armand	Painting, Oil,Portrait, Landscape, Still Life, Impressionism, France, 19th Century
Guillemin, Grégoire	Illustration, Painting, Pop-Art, France
Gutekunst, Saskia	Illustration, Concept Art, Germany
Guweiz (Zheng Wei Gu)	Illustration, Portrait, Singapore
Hacker, Arthur	Painting, Oil, Portrait, UK, 19th Century
Haeckel, Ernst	Illustration, Germany, 19th Century
Hamilton, Richard	Painting, Oil, Acrylic, Collage, Pop-Art, UK
Hanson, Erin	Painting, Landscape, Oil, USA
Hanuka, Tomer	Illustration, Israel
Hardy, David A.	Illustration, Painting, Sci-Fi, Cover Art, Landscape, UK
Haring, Keith	Illustration, Painting, Pop-Art, USA
Harper, Charley	Illustration, Flat Style, USA
Harrington, Conor	Painting, Oil, Grafitti, Portrait, Ireland
Harris, John	Illustration, Painting, Sci-Fi, Cover Art, UK
Harris, Lawren	Painting, Landscape, Oil, Canada
Hartley, Marsden	Painting, Oil, Still Life, Landscape, Moderism, USA
Hartung, Hans	Painting, Informel, Tachisme, Abstract, B&W, Germany, France
Hasui, Kawase	Illustration, Woodcut, Japan
Hattori, Naoto	Painting, Fantasy, Japan
Heem, Cornelis de	Painting, Oil, Still Life, Botanical, 17th Century, Netherlands
Heighton, Brent	Illustration, Painting, Oil, Watercolor, Cityscape, Canada
Herrero, Lowell	Painting, Oil, Naive Art, USA
Hess, F. Scott	Painting, Oil, Portrait, Realism, USA
Hickman, Stephen	Illustration, Fantasy, Sci-Fi, Cover Art, USA
Hiroshige, Utagawa	Illustration, Woodcut, Japan, 19th Century
Hitch, Bryan	Comic, DC Comics, Marvel, UK
Hodas, Filip	3D, Landscape, Czech Republic
Hodler, Ferdinand	Painting, Oil, Art Nouveau, Symbolism, Switzerland, 19th Century
Hokusai (Katsushika Hokusai)	Painting, Ink, Woodblock Print, Japan, 18th Century
Holbein, Ambrosius	Painting, Oil, Woodcut, Portrait, Mythology, Germany, 16th Century
Holbein, Hans	Painting, Oil, Portrait, Germany, 15th Century
Homer, Winslow	Illustration, Painting, Oil, Landscape, Realism, USA, 19th Century
Hong, Frank	Illustration, Concept Art, Game Art, Animation, Canada
Hooch, Pieter de	Painting, Oil, Portrait, Netherlands, 17th Century
Hopper, Edward	Painting, Oil, Realism, USA
Horkey, Aaron	Illustration, B&W, USA
Horley, Alex	Illustration, Comic, Nudity, DC Comics, Marvel, Hearthstone, Cover Art, Game Art, USA
Hornel, Edward Atkinson	Painting, Oil, Portrait, Scotland, UK, 19th Century
Howe, John	Illustration, Concept Art, Tolkien, Canada
Hoyland, John	Painting, Acrylic, Abstract, UK
Hue, Sebastien	Illustration, Concept Art, France
Hughes, Adam	Illustration, Comic, DC Comics, Marvel, USA
Hughes, Edward Robert	Painting, Oil, Watercolor, Tempera, Portrait, UK
Hurrell, George	Photography, Portrait, B&W, USA
Hutter, Michael	Illustration, Painting, Germany
Huynh, Duy	Painting, Acrylic, Surrealism, Vietnam, USA
Hyde, Catherine	Illustration, USA
Höch, Hannah	Painting, Oil, Tempera, Watercolor, Collage, Portrait, Dada, Germany
Icart, Louis	Illustration, Painting, France, 19th Century
Immonen, Stuart	Comic, DC Comics, Marvel, Canada
Inceoglu, Ismail	Illustration, Concept Art, Fantasy, Bulgaria
Infantino, Carmine	Comic, DC Comics, Marvel, USA
Ingpen, Robert	Illustration, Children's Book, Australia
Ingres, Jean-Auguste-Dominique	Painting, Oil, Portrait, Neoclassicism, Orientalism, France, 19th Century
Inoue, Takehiko	Illustration, Manga, Japan
Ishida, Sui	Illustration, Manga, Japan
Itten, Johannes	Painting, Oil, Watercolor, Expressionism, Bauhaus, Switzerland
Itō, Junji	Illustration, Manga, Horror, B&W, Japan
Jacinto, Jorge	Illustration, Concept Art, Sci-Fi, Fantasy, Game Art, MTG, Portugal
Jacklin, Bill	Painting, Oil, Pastel, Portrait, Landscape, Still Life, UK
Jakubowski, Marcin	Illustration, Character Design, Concept Art, Poland
Jansson, Alexander	Illustration, Sweden
Jasinski, Aaron	Illustration, Children's Book, Cover Art, USA
Jean, James	Illustration, Painting, Taiwan
Jeffers, Oliver	Author, Illustration, Children's Book, Australia
Jewett, Ellen	Sculpture, Canada
Jia, Ruan	Illustration, Concept Art, Game Art, China
Jimenez, Phil	Comic, DC Comics, USA
Johnstone, Dorothy	Painting, Oil, Watercolor, Gouache, Portrait, Scotland, UK
Jones, (Android) Andrew	Illustration, Concept Art, Game Art, USA
Jones, Jeffrey Catherine	Illustration, Cover Art, USA
Jover, Loui	Collage, Ink, B&W, Australia
Jullien, Jean	Illustration, Flat Style, France
Jurgens, Mandy	Illustration, Portrait, USA
Jusko, Joe	Illustration, Comic, Fantasy, DC Comics, Marvel, USA
Kago, Shintarō	Illustration, Manga, Horror, Japan
Kahraman, Hayv	Painting, Oil, Portrait, Iraq, USA
Kaluta, Michael William	Illustration, Comic, DC Comics, Marvel, Cover Art, Guatemala, USA
Kandinsky, Wassily	Painting, Expressionism, Abstract, Russia
Kashin, Wadim	Concept Art, Sci-Fi, Poland
Katz, Alex	Painting, Pop-Art, USA
Kawasaki, Audrey	Illustration, Painting, Oil, Charcoal, Portrait, USA
Keane, Glen	Illustration, Animation, Disney, USA
Keever, Kim	Photography, USA
Kehoe, Andy	Illustration, Fantasy, USA
Kelly, Ken	Painting, Fantasy, USA
Kelly-Freas, Frank	Illustration, Painting, Fantasy, Sci-Fi, Cover Art, USA
Kentridge, William	Illustration, Charcoal, B&W, South Africa
Kesinger, Brian	Illustration, Comic, Disney, USA
Ketner, Jeremiah	Illustration, USA, Japan
Kiefer, Anselm	Painting, Oil, Acrylic, Germany
Kieth, Sam	Comic, DC Comics, USA
Kim, Jung-Gi	Illustration, B&W, South Korea
Kinkade, Thomas	Painting, Oil, USA
Kirby, Jack	Comic, DC Comics, Marvel, USA
Kirchner, Ernst Ludwig	Painting, Oil, Portrait, Landscape, Expressionism, Germany
Kirchner, Raphael	Illustration, Painting, Art Nouveau, Austria, 19th Century
Kiuchi, Tatsuro	Illustration, Painting, Japan
Klarwein, Abdul Mati	Painting, Oil, Portrait, Cover Art, Surrealism, Germany, France
Klassen, Jon	Illustration, Animation, Children's Book, Canada
Klee, Paul	Painting, Oil, Watercolor, Expressionism, Bauhaus, Switzerland
Klimt, Gustav	Painting, Oil, Symbolism, Art Nouveau, Austria, 19th Century
Klint, Hilma af	Painting, Oil, Watercolor, Abstract, Symbolism, Sweden
Knab, Ferdinand	Painting, Oil, Architecture, Germany, 19th Century
Knight, Nick	Photography, Fashion, UK
Knights, Winifred Margaret	Painting, Oil, Naive Art, UK
Kojima, Ayami	Illustration, Character Design, Concept Art, Konami, Japan
Kokoschka, Oskar	Painting, Oil, Portrait, Landscape, Expressionism, Austria
Kollwitz, Käthe	Painting, Lithography, Expressionism, B&W, Sculpture, Germany
Kon, Satoshi	Anime, Japan
Kooning, Willem de	Painting, Oil, Abstract, Expressionism, Netherlands, USA
Koons, Jeff	Sculpture, Postmodernism, USA
Koson, Ohara	Illustration, Painting, Japan
Kotak, Bella	Photography, Portrait, UK
Kramskoi, Ivan (Ivan Nikolaevič Kramskoj)	Painting, Oil, Portrait, Realism, Russia, 19th Century
Krishnamani, Ranganath	Illustration, Flat Style, India
Krull, Germaine	Photography, Portrait, B&W, Germany
Kubin, Alfred	Author, Illustration, Expressionism, Symbolism, B&W, Austria, Hungary
Kuciara, Maciej	Illustration, Concept Art, Sci-Fi, Game Art, Poland
Kunisada, Utagawa	Drawing, Portrait, Woodcut, Japan, 19th Century
Kurosawa, Akira	Movie Director, B&W, Japan
Kurtzman, Harvey	Comic, Mad Magazine, USA
Kusama, Yayoi	Painting, Sculpture, Pattern, Pop-Art, Japan
Kutsche, Michael	Illustration, Character Design, Fantasy, Germany
Kuvshinov, Ilya	Illustration, Animation, Character Design, Russia
LaChapelle, David	Photography, Portrait, USA
Lacoste, Raphael	Illustration, Concept Art, Game Art, France
Lagerstedt, Mikko	Photography, Landscape, Finland
Landseer, Edwin	Painting, Oil, Portrait, Animals, Dogs, Romanticism, UK, 19th Century
Lane, Fitz Henry	Painting, Oil, Landscape, Marine, USA, 19th Century
Larson, Abigail	Illustration, Character Design, Watercolor, Ink, Gothic, USA
Larson, Gary	Author, Illustration, Comic, Cartoon, USA
Larsson, Carl	Illustration, Watercolor, Sweden, 19th Century
Lassnig, Maria	Painting, Oil, Portrait, Austria
Lawrence, Don	Comic, Watercolor, Gouache, UK
Lecouffe-Deharme, Bastien	Illustration, Sci-Fi, Fantasy, France
Lee, Alan	Illustration, Concept Art, Tolkien, UK
Lee, Jae	Comic, DC Comics, Marvel, USA
Lee, Jim	Comic, DC Comics, Marvel, South Korea, USA
Lehr, Paul	Illustration, Sci-Fi, Cover Art, USA
Lemire, Jeff	Illustration, Watercolor, Comic, DC Comics, Marvel, USA
Lentulov, Aristarkh	Painting, Oil, Cubism, Russia
Leyendecker, Joseph Christian	Illustration, Art Nouveau, Cover Art, Germany, 19th Century
Lhote, André	Painting, Oil, Gouache, Portrait, Landscape, Cubism, France
Lichtenstein, Roy	Painting, Pop-Art, USA
Liefeld, Rob	Comic, DC Comics, Marvel, USA
Lifsches, Iwona	Illustration, Painting, Acrylic, Children's Book, Poland, Denmark
Lindner, Richard	Illustration, Painting, Lithography, Pop-Art, Germany, USA
Liniers	Illustration, Comic, Cartoon, Argentina
Lippi, Filippino	Painting, Oil, Portrait, Mythology, Italy, 15th Century
Lipton, Laurie	Illustration, Pencil, Portrait, B&W, USA
Lismer, Arthur	Painting, Landscape, Oil, Canada
Lisowski, Michal	Concept Art, Game Art, Poland
Listfield, Scott	Painting, Oil, USA
Loftis, Cory	Illustration, Animation, Character Design, Disney, USA
Loish (Lois van Baarle)	Illustration, Character Design, Concept Art, Portrait, Netherlands
Loomis, Andrew	Illustration, Painting, USA
Lourenço, Didier	Painting, Lithography, Spain
Lovecraft, H.P.	Author, Horror, USA
Lovell, Tom	Illustration, Painting, USA
Luce, Maximilien	Painting, Oil, Pointillism, France
MacDonald Mackintosh, Margaret	Illustration, Watercolor, Ink, Art Nouveau, UK, 19th Century
MacDonald McNair, Frances	Illustration, Watercolor, Ink, Art Nouveau, UK, 19th Century
MacNicol, Bessie (Elizabeth)	Painting, Oil, Portrait, Scotland, UK, 19th Century
Macara, Andrew	Painting, Oil, UK
Macke, August	Painting, Oil, Watercolor, Portrait, Landscape, Expressionism, Germany
Mahfood, Jim (Food One)	Comic, USA
Makart, Hans	Painting, Oil, Orientalism, Austria, 19th Century
Maleew, Alex	Illustration, Comic, DC Comics, Marvel, Bulgaria
Maller, Justin	Illustration, Australia
Manara, Milo	Illustration, Watercolor, Acrylic, Comic, Graphic Novel, Nudity, Italy
Manchess, Gregory	Illustration, Painting, Oil, Cover Art, USA
Maniak, Slawomir	Illustration, Concept Art, Cover Art, Fantasy, MTG, Poland
Mann, Jeremy	Painting, Oil, USA
Manoukian, Stan	Illustration, Fantasy, France
Mantegna, Andrea	Painting, Oil, Tempera, Portrait, Mythology, Italy, 15th Century
Manutius, Aldus	Printer, Woodcut, Engraving, Italy, 15th Century
Maroto, Esteban	Illustration, Comic, DC Comics, Marvel, Spain
Mars, Chris	Painting, Oil, Pastel, Cover Art, Horror, USA
Martin, John	Painting, Oil, UK
Martinière, Stephan	Illustration, Concept Art, Fantasy, Sci-Fi, France
Masereel, Frans	Painting, Woodcut, B&W, Belgium
Mashburn, Brian	Painting, Ink, Gouache, Watercolor, Landscape, USA
Masson, André	Painting, Oil, Cubism, Surrealism, USA
Matisse, Henri	Painting, Oil, Gouache, France
Matthews, Rodney	Illustration, Fantasy, UK
Mattingly, David	Illustration, Painting, Fantasy, Sci-Fi, Cover Art, USA
Matutina, Dan	Illustration, Philippines
Mayhew, Mike	Illustration, Comic, DC Comics, Marvel, Cover Art, USA
McAllister, Cathleen	Illustration, Character Design, Concept Art, Game Art, Covert Art, Animation, USA
McCall, Robert T.	Illustration, Painting, Sci-Fi, Cover Art, USA
McCarthy, Frank	Illustration, Painting, USA
McCay, Winsor	Illustration, Comic, Cartoon, Architecture, USA
McCubbin, Frederick	Painting, Oil, Landscape, Australia, 19th Century
McFarlane, Todd	Comic, DC Comics, Marvel, Canada
McGee, Barry	Illustration, Grafitti, Street Art, Sculpture, USA
McKean, Dave	Illustration, Comic, Children's Book, UK
McKie, Angus	Illustration, Sci-Fi, Cover Art, UK
McKinnon, Seb	Illustration, Fantasy, MTG, Canada
McPharlin, Dan	Illustration, Concept Art, Sci-Fi, Cover Art, Surrealism, Australia
McPherson, Tara	Illustration, Painting, USA
McQuarrie, Ralph Angus	Concept Art, Sci-Fi, Star Wars, USA
McQue, Ian	Illustration, Concept Art, Sci-Fi, Game Art, Scotland, UK
Mead, Syd	Industrial Design, Concept Art, Sci-Fi, USA
Mell, Ed	Painting, Oil, Landscape, USA
Memling, Hans	Painting, Oil, Portrait, Mythology, Germany, 15th Century
Mendoza, Eddie	Illustration, Concept Art, Game Art, USA
Menzel, Adolph von	Illustration, Painting, Oil, Portrait, Realism, Germany
Merian, Maria Sibylla	Painting, Illustration, Engraving, Botanical, Germany, 17th Century
Merriam, Daniel	Illustration, Painting, Watercolor, Surrealism, USA
Messina, Antonello da	Painting, Oil, Portrait, Mythology, Italy, 15th Century
Metzinger, Jean	Painting, Oil, Guache, Portrait, Landscape, Cubism, France
Middleton, Joshua	Illustration, Comic, Ink, DC Comics, Marvel, USA
Mignola, Mike	Comic, Ink, Watercolor, USA
Mili, Gjon	Photography, Dance, Albania
Miller, Frank	Comic, DC Comics, Marvel, USA
Miller, Ian	Illustration, Ink, Watercolor, Fantasy, Gothic, Cover Art, USA
Mills, Russ	Illustration, Cover Art, UK
Miura, Kentarō	Illustration, Manga, B&W, Japan
Miyazaki, Hayao	Movie Director, Anime, Ghibli, Japan
Mizer, Bob	Photography, Movie Director, Portrait, Pin-Ups, Nudity, USA
Mizuno, Junko	Illustration, Manga, Japan
Modigliani, Amedeo	Painting, Oil, Sculpture, Expressionism, Italy
Moebius (Giraud, Jean)	Illustration, Comic, France
Mohrbacher, Peter	Illustration, Fantasy, USA
Monet, Claude	Painting, Oil, Landscape, Portrait, Impressionism, France, 19th Century
Monge, Jean-Baptiste	Illustration, Character Design, Fantasy, Canada
Moore, Chris	Illustration, Painting, Sci-Fi, Cover Art, UK
Mora, Dan (Chaves)	Illustration, Comic, Sci-Fi, Fantasy, Costa Rica
Moran, Thomas	Painting, Oil, Landscape, USA, 19th Century
Morandi, Giorgio	Painting, Oil, Still Life, Italy
Moreau, Gustave	Painting, Oil, Symbolism, Nudity, France, 19th Century
Moret, Henry	Painting, Oil, Landscape, Marine, Impressionism, France, 19th Century
Morisot, Berthe	Painting, Oil, Portrait, France, 19th Century
Moronobu, Hishikawa	Painting, Japan, 17th Century
Morrell, Stefan	Illustration, Character Design, Concept Art, Game Art, USA
Morris, William	Illustration, Painting, Print, Wallpaper, UK, 19th Century
Morrocco, Alberto	Painting, Oil, Scotland, UK
Morski, Igor	Illustration, Surrealism, Poland
Mortensen, John Kenn	Illustration, Denmark
Mortensen, William	Photography, Portrait, Glamour, B&W, USA
Moscoso, Victor	Comic, Poster, Psychedelic Art, Lithography, Spain, USA
Moss, Olly	Illustration, Concept Art, Poster, USA
Mucha, Alfons (Alphonse)	Illustration, Art Nouveau, Czech Republic, 19th Century
Mullins, Craig	Illustration, Game Art, USA
Mumford, Dan	Illustration, Cover Art, UK
Munari, Bruno	Illustration, Graphic Design, Italy
Munch, Edvard	Painting, Oil, Expressionism, Symbolism, Norway, 19th Century
Murai, Will	Illustration, Blizzard, Hearthstone, MTG, USA
Murakami, Takashi	Illustration, Visual Arts, Superflat, Japan
Murata, Yusuke	Illustration, Manga, Japan
Nagai, Hiroshi	Illustration, Landscape, Japan
Nagai, Kazumasa	Illustration, Graphic Design, Poster, Japan
Nagel, Patrick	Illustration, Painting, Cover Art, Flat Style, Portrait, USA
Naismith, Scott	Painting, Landscape, Oil, Scotland, UK
Nasmith, Ted	Illustration, Concept Art, Tolkien, Canada
Nasmyth, Alexander	Painting, Oil, Landscape, Scotland, UK, 18th Century
Neel, Alice	Painting, Oil, Portrait, Expressionism, USA
Negley, Keith	Illustration, Cover Art, Flat Style, USA
Nelson, Kadir	Illustration, Painting, Portrait, Cover Art, USA
Nelson, R. Kenton	Painting, USA
Nerdrum, Odd	Painting, Oil, Lithography, Portrait, Norway
Newland, Jane	Illustration, Watercolor, Flat Style, UK
Ngai, Victo	Illustration, Children's Book, USA
Nguyen, Dustin	Comic, DC Comics, USA
Nielsen, Kay	Illustration, Disney, Denmark
Nihei, Tsutomu	Illustration, Manga, Sci-Fi, Japan
Nirasawa, Yasushi	Illustration, Character Design, Japan
Nizovtsev, Victor	Painting, Russia
Nolin, Catherine	Painting, Acrylic, Oil, Portrait, Interior, USA
Norem, Earl	Illustration, Comic, Poster, Cover Art, Marvel, USA
North, Marianne	Painting, Landscape, Botanical, UK, 19th Century
Oakley, Thornton	Illustration, Charcoal, Gouache, Watercolor, USA
Ofili, Chris	Painting, Watercolor, Charcoal, UK
Ojala, Eiko	Illustration, Cover Art, Flat Style, Estonia
Olley, Margaret	Painting, Oil, Still Life, Botanical, Australia
Olschinsky, Atelier	Illustration, 3D, Sci-Fi, Austria
Oprisco, Oleg	Photography, Portrait, Ukraine
Otomo, Katsuhiro	Illustration, Manga, Japan
Otomo, Shohei	Illustration, Ink, B&W, Japan
Oum, Siya	Comic, DC Comics, Marvel, USA
O’Keeffe, Georgia	Painting, Oil, USA
P.A. Works	Anime, Japan
Panter, Gary	Illustration, Painting, Comic, Author, Acrylic, Ink, USA
Paolozzi, Eduardo	Illustration, Lithography, Collage, Pop-Art, Scotland, UK
Parel, Gerald	Illustration, Game Art, Germany
Parmigianino	Painting, Oil, Portrait, Mythology, Italy, 16th Century
Parrish, Maxfield	Illustration, Painting, Oil, USA
Paschke, Edward Francis	Painting, Oil, Portrait, Expressionism, Abstract, USA
Peak, Bob	Illustration, Poster, Cover Art, USA
Peeters, Clara	Painting, Oil, Still Life, Belgium
Pei, Guo	Fashion Designer, Fashion, China
Pennington, Bruce	Painting, Fantasy, Sci-Fi, UK
Perceval, John	Painting, Australia
Peterson, Cleon	Painting, Acrylic, Print, B&W, USA
Petolas, Nikolina	Illustration, Painting, Photography, Concept Art, Croatia
Phillips, Coles	Illustration, Watercolor, USA
Phillips, Sean	Illustration, Comic, DC Comics, Marvel, UK
Picabia, Francis-Marie Martinez	Painting, Oil, Watercolor, Portrait, Dada, Surrealism, Cubism, France
Picolo, Gabriel	Illustration, Comic, DC Comics, Blizzard, Brazil
Pieck, Anton Franciscus	Illustration, Painting, Watercolor, Ink, Gouache, Netherlands
Pinkney, Jerry	Illustration, Watercolor, Children's Book, USA
Pirner, Maximilian	Illustration, Painting, Oil, Czech Republic
Pollock, Jackson	Painting, Expressionism, USA
Pontormo, Jacopo da	Painting, Oil, Portrait, Mythology, Italy, 16th Century
Pope, Paul	Comic, DC Comics, USA
Porter, Fairfield	Painting, Oil, Portrait, USA
Portinari, Candido	Painting, Oil, Portrait, Brazil
Prades, Simón	Illustration, Ink, Germany
Pranckevicius, Gediminas	Illustration, Animation, Concept Art, Lithuania
Pratt, Hugo	Illustration, Watercolor, Ink, Comic, Graphic Novel, Italy
Prins, Theo	Concept Art, USA
Procter, Dod	Painting, Oil, Portrait, UK
Procter, Ernest	Painting, Oil, Portrait, UK
Provensen, Alice	Illustration, Children's Book, USA
Purcell, Steve	Comic, Animation, Character Design, Game Art, USA
Putz, Leo	Painting, Oil, Portrait, Italy
Q Hayashida (Hayashida Kyū)	Illustration, Manga, Horror, Japan
Quitely, Frank	Illustration, Comic, DC Comics, Marvel, Cover Art, Scotland, UK
Rackham, Arthur	Illustration, Watercolor, Ink, Children's Book, Art Nouveau, UK, 19th Century
Raleigh, Henry Patrick	Illustration, Watercolor, Charcoal, USA
Ramos, Humberto	Illustration, Comic, DC Comics, Marvel, Cover Art, Mexico
Rand, Paul	Illustration, Graphic Design, Logo, USA
Raphael (Raffaello Sanzio da Urbino)	Painting, Oil, Portrait, Mythology, Italy, 15th Century
Ravi Zupa	Illustration, Painting, Print, USA
Rebelka, Jakub	Illustration, Concept Art, Poland
Redon, Odilon	Painting, Symbolism, France, 19th Century
Redpath, Anne	Painting, Oil, Still Life, Landscape, Scotland, UK
Reiniger, Lotte	Movie Director, Animation, Silhouette, B&W, Germany
Rembrandt (van Rijn)	Painting, Oil, Portrait, Baroque, Netherlands, 17th Century
Remnev, Andrey	Painting, Oil, Portrait, Russia
Renoir, Pierre-Auguste	Painting, Oil, Portrait, Impressionism, France, 19th Century
Repin, Ilya/Ilja	Painting, Oil, Portrait, Ukraine, 19th Century
Retz, Zac	Illustration, Animation, Concept Art, Character Design, USA
Rhads (Artem Chebokha)	Illustration, Landscape, Russia
Rhead, Louis	Illustration, Poster, Art Nouveau, B&W, UK, USA
Rhodes, Matt	Illustration, Concept Art, Game Art, USA
Rigaud, Hyacinthe	Painting, Oil, Portrait, Baroque, France, 17th Century
Rikalo, Jovana	Photography, Portrait, Serbia
Riley, Bridget	Illustration, Painting, Op-Art, Geometry, Pattern, UK
Ringgold, Faith	Painting, Oil, Acrylic, USA
Riopelle, Jean-Paul	Painting, Oil, Expressionism, Abstract, USA
Rivera, Diego	Painting, Portrait, Muralismo, Realism, Mexico
Robbins, Trina	Illustration, Comic, DC Comics, Marvel, B&W, USA
Robida, Albert	Illustration, Painting, Lithography, France, 19th Century
Robinson, William Heath	Illustration, Ink, Watercolor, Cartoon, USA
Rocha, Andreas	Concept Art, Fantasy, Sci-Fi, Portugal
Rockwell, Norman	Illustration, Painting, Cover Art, USA
Roerich, Nicholas	Painting, Tempera, Landscape, Symbolism, Russia, 19th Century
Rolando, Cyril	Illustration, France
Roset, Conrad	Illustration, Painting, Ink, Watercolor, Spain
Ross, Alex	Painting, Gouache, Comic, DC Comics, Marvel, Poster, USA
Rossier, Jessica	Concept Art, Landscape, France
Rothko, Mark	Painting, Oil, Abstract, Expressionism, Russia, USA
Rousseau, Henri	Painting, Oil, Landscape, Botanical, Naive Art, France, 19th Century
Roversi, Paolo	Photography, Fashion, Italy
Ruas, João	Illustration, Horror, Brazil
Rubens, Peter Paul	Painting, Oil, Portrait, Mythology, Flemish, 17th Century
Rutkowski, Grzegorz (Greg)	Illustration, Concept Art, Fantasy, Poland
Ruysch, Rachel	Painting, Oil, Still Life, Botanical, Netherlands, 17th Century
Ryden, Mark	Painting, USA
Ryder, Albert Pinkham	Painting, Oil, Landscape, USA, 19th Century
Ryohei Hase	Illustration, Cover Art, Horror, Japan
Rysselberghe, Théo van	Painting, Oil, Pointillism, Belgium
Saftleven, Cornelis	Painting, Oil, Landscape, Portrait, Netherlands, 17th Century
Sage, Amanda	Painting, Oil, Psychedelic Art, USA
Saintclair, Apollonia	Illustration, Ink, Nudity, B&W, France
Salminen, John	Illustration, Watercolor, Landscape, USA
Samorì, Nicola	Painting, Oil, Sculpture, Italy
Sandoval, Tony	Illustration, Watercolor, USA
Sargent, John Singer	Painting, Oil, Watercolor, Portrait, USA, 19th Century
Sarnoff, Arthur	Illustration, Painting, Oil, Portrait, Cover Art, USA
Sarrailh, Sylvain	Illustration, Concept Art, Game Art, France
Sarto, Andrea del	Painting, Oil, Portrait, Mythology, Italy, 16th Century
Saryan, Martiros	Painting, Oil, Tempera, Landscape, Russia, Armenia
Savrasov, Alexei	Painting, Oil, Landscape, Russia, 19th Century
Scarry, Richard	Illustration, Watercolor, Children's Book, USA
Schalcken, Godfried	Painting, Oil, Portrait, Netherlands, 17th Century
Schaller, Thomas W.	Painting, Watercolor, Architecture, Cityscape, USA
Scher, Paula	Illustration, Graphic Design, Painting, USA
Schiele, Egon	Illustration, Painting, Oil, Portrait, Expressionism, Austria
Schjerfbeck, Helene	Painting, Oil, Portrait, Realism, Finland, 19th Century
Schoeller, Martin	Photography, Portrait, Germany
Schoenherr, John Carl	Illustration, Children's Book, Sci-Fi, Dune, USA
Schomburg, Alex	Illustration, Comic, Marvel, Cover Art, Puerto Rico, USA
Schongauer, Martin	Painting, Illustration, Engraving, Mythology, Germany, 15th Century
Schrieck, Otto Marseus van	Painting, Oil, Still Life, Botanical, Netherlands, 17th Century
Schuiten, François	Comic, Graphic Novel, Belgium
Schwabe, Carlos	Illustration, Painting, Art Nouveau, Germany, 19th Century
Schwitters, Kurt	Painting, Oil, Watercolor, Collage, Dada, Surrealism, Germany, UK
Seddon-Boulet, Susan	Painting, Ink, Brazil
Seignac, Guillaume	Painting, Oil, Portrait, France
Semenov, Anton	Illustration, Horror, Russia
Seurat, Georges	Painting, Oil, Pointillism, France
Severin, Marie	Comic, DC Comics, Marvel, USA
Seveso, Alberto	Illustration, Photography, Portrait, UK
Shaden, Brooke	Photography, Portrait, USA
Shaw, Barclay	Painting, Acrylic, Fantasy, Sci-Fi, Cover Art, USA
Shepard, Ernest Howard	Illustrator, Painting, Winnie-the-Pooh, UK
Sheppard, Cynthia	Illustration, MTG, USA
Shields, Tyler	Photography, Portrait, USA
Shimizu, Yuko	Illustration, USA
Shinkai, Makoto	Anime, Japan
Shinkawa, Yōji	Illustration, Concept Art, Japan
Shinn, Everett	Illustration, Painting, Oil, Watercolor, USA
Shirow, Masamune	Illustration, Manga, Sci-Fi, Japan
Shiu, Emmanuel	Concept Art, Sci-Fi, USA
Siemiradzki, Henryk	Painting, Oil, Portrait, Mythology, Ukraine, Poland, 19th Century
Sienkiewicz, Bill	Illustration, Comic, DC Comics, Marvel, USA
Signac, Paul	Painting, Oil, Pointillism, France
Silvestri, Marc	Comic, DC Comics, Marvel, USA
Simkins, Greg	Painting, Acrylic, Graffiti, USA
Simonetti, Marc	Illustration, Concept Art, Game Art, France
Siqueiros, David Alfaro	Painting, Portrait, Muralismo, Realism, Mexico
Sloan, Kevin	Painting, Oil, USA
Smith, Grace Cossington	Painting, Oil, Australia
Soutine, Chaim	Painting, Oil, Portrait, Expressionism, Belarus, France
Spare, Austin Osman	Illustration, Painting, Chalk, Pastel, Art Nouveau, Symbolism, Occultism, UK
Sparth	Illustration, Concept Art, Game Art, Sci-Fi, USA
Sperry, Chuck	Illustration, Screen Print, Portrait, USA
Spratt, Sam	Illustration, Painting, USA
Steadman, Ralph	Author, Illustration, Comic, Cartoon, UK
Stelfreeze, Brian	Comic, DC Comics, Marvel, USA
Stieglitz, Alfred	Photography, Portrait, B&W, USA, 19th Century
Stokoe, James	Comic, DC Comics, Marvel, Canada
Streeton, Arthur Ernest	Painting, Oil, Watercolor, Landscape, Australia, 19th Century
Struzan, Drew	Illustration, Poster, USA
Strzalkowski, Tomasz	3D, Character Design, Game Art, Poland
Stålenhag, Simon	Concept Art, Sci-Fi, Sweden
Sugimori, Ken	Illustration, Game Art, Pokemon, Japan
Sutherland, Graham	Painting, Oil, Gouache, Expressionism, UK
Suydam, Arthur	Illustration, Comic, Marvel, USA
Swanland, Raymond	Illustration, Concept Art, Sci-Fi, Fantasy, Game Art, MTG, USA
Sève, Peter de	Illustration, Animation, Cover Art, USA
Takahashi, Hiroyuki-Mitsume	Illustration, Comic, Japan
Takahashi, Kazuya	Illustration, Game Art, Japan
Takahashi, Rumiko	Illustration, Manga, Japan
Tamayo, Rufino	Painting, Oil, Cubism, Surrealism, Abstract, Mexico
Tan, Shaun	Illustration, Painting, Ink, Oil, Australia
Tanner, Henry Ossawa	Painting, Oil, Portrait, USA, 19th Century
Tartakovsky, Genndy	Illustration, Animation, Character Design, TV, Russia, USA
Templesmith, Ben	Illustration, Comic, Australia
Teng, Sachin	Illustration, Comic, Poster, Cover Art, USA
Tenggren, Gustaf	Illustration, Disney, USA
Tepper, Saul	Illustration, Painting, Oil, Portrait, USA
Terada, Katsuya	Illustration, Japan
Terpning, Howard	Illustration, Painting, Oil, Portrait, Landscape, Realism, USA
Tezuka, Osamu	Illustration, Manga, Japan
Thayer, Abbott Handerson	Painting, Oil, Portrait, USA, 19th Century
Thole, Karel	Illustration, Painting, Netherlands
Thomas, Mickalene	Painting, Acrylic, Photography, Collage, USA
Thompson, Craig	Comic, Graphic Novel, Ink, B&W, USA
Thomson, Tom	Painting, Oil, Landscape, Canada, 19th Century
Tiepolo, Giovanni	Painting, Oil, 18th Century
Timmermans, Alex	Photography, Netherlands
Titian (Tiziano Vecelli)	Painting, Oil, Portrait, Mythology, Italy, 16th Century
Tomine, Adrian	Illustration, Comic, Cover Art, USA
Toor, Ori	Illustration, Israel
Toriyama, Akira	Illustration, Manga, Anime, DragonBall, Japan
Toth, Alex	Comic, DC Comics, B&W, USA
Toulouse-Lautrec, Henri de	Illustration, Painting, France, 19th Century
Tran, Ross (RossDraws)	Illustration, Character Design, Concept Art, Portrait, USA
Turner, William	Painting, Oil, Watercolor, Landscape, Romanticism, UK, 19th Century
Turnham, Chris	Illustration, USA
Tutwiler, David	Painting, Oil, Watercolor, Landscape, USA
Uesugi, Tadahiro	Illustration, Japan
Uglow, Euan	Painting, Oil, Still Life, Portrait, UK
Uhlig, Daniela	Illustration, Character Design, Game Art, Germany
Ural, Halil	Illustration, Concept Art, Game Art, Turkey
Urschel, Jan	Illustration, Concept Art, Sci-Fi, Game Art, Germany
Vallejo, Boris	Illustration, Painting, Cover Art, Poster, Pin-Ups, Fantasy, Peru, USA
Van Gogh, Vincent Willem	Painting, Oil, Pointillism, Netherlands, 19th Century
Vargas, Alberto	Illustration, Pin-Ups, USA
Vasarely, Victor	Illustration, Painting, Op-Art, Geometry, Pattern, Hungary, France
Vaughan, Brian K.	Comic, Graphic Novel, DC Comics, Marvel, USA
Velázquez, Diego	Painting, Oil, Portrait, Baroque, Spain, 17th Century
Vereshchagin, Vasily	Painting, Oil, Realism, Orientalism, Russia, 19th Century
Verrocchio, Andrea del	Painting, Oil, Italy, 15th Century
Vesalius, Andreas	Author, Illustration, Anatomy, Engraving, Woodcut, Belgium, 16th Century
Vess, Charles	Comic, Fantasy, USA
Vigée-Lebrun, Élisabeth	Painting, Oil, Portrait, Rococo, France, 18th Century
Wain, Louis	Illustration, Painting, Ink, Watercolor, Gouache, Cat, UK, 19th Century
Walala, Camille	Illustration, Painting, Visual Arts, Pattern, France
Walde, Alfons	Painting, Oil, Landscape, Austria
Wallis, Alfred	Painting, Landscape, UK
Ward, Lynd	Author, Illustration, Children's Book, Graphic Novel, Woodcut, Engraving, USA
Warhol, Andy	Painting, Pop-Art, USA
Waterhouse, John William	Painting, Oil, Portrait, UK, 19th Century
Watteau, Jean-Antoine	Painting, Oil, Portrait, Rococo, France, 18th Century
Webb, Joe	Collage, Print, UK
Weeks, Edwin Lord	Illustration, Painting, Orientalism, USA
Weissenbruch, Johan Hendrik	Painting, Oil, Watercolor, Landscape, Netherlands, 19th Century
Weldon, Casey	Painting, Acrylic, Surrealism, USA
Whalen, Tom (Strongstuff)	Illustration, USA
Whelan, Michael	Illustration, Fantasy, Sci-Fi, USA
Whitcomb, Jon	Illustration, Painting, Oil, Gouache, Poster, USA
Whitmore, Coby	Illustration, Painting, Cover Art, USA
Wileman, Peter	Painting, Oil, Landscape, Abstract, UK
Wiley, Kehinde	Painting, Oil, Portrait, USA
Wilkins, Edward Blair	Illustration, Painting, Sci-Fi, Cover Art
Williamson, Al	Comic, USA
Willink, Carel	Painting, Oil, Portrait, Cityscape, Architecture, Realism, Netherlands
Windsor-Smith, Barry	Comic, DC Comics, Marvel, B&W, UK
Winterhalter, Franz Xaver	Painting, Oil, Portrait, Germany, 19th Century
Wirth, Nathan	Photography, Landscape, B&W, USA
Wlop	Illustration, China
Woelfel, Brandon	Photography, Portrait, USA
Wong, Liam	Photography, Game Art, Scotland, UK
Wood, Ashley	Illustration, Comic, Painting, Ink, Australia
Wood, Grant	Painting, Oil, Tempera, Portrait, USA
Wou-Ki, Zao	Painting, Ink, Aquatint, China
Wrightson, Bernie	Comic, DC Comics, Marvel, B&W, USA
Wyeth, Andrew	Painting, Oil, Watercolor, Gouache, Portrait, Landscape, Realism, USA
Xu, Zhelong	Illustration, 3D, China
Yata, Hannah	Painting, Oil, Psychedelic Art, Surrealism, USA
Ye, Liu	Painting, China
Yeager, Bunny	Photography, Portrait, Pin-Ups, Nudity, USA
Yerka, Jacek	Illustration, Painting, Surrealism, Poland
Yokoo, Tadanori	Illustration, Graphic Design, Poster, Japan
Yoro, Sean (HULA)	Painting, Street Art, Portrait, USA
Yoshida, Akihiko	Illustration, Character Design, Game Art, Japan
Yoshida, Hiroshi	Painting, Landscape, Japan
Young, Skottie	Illustration, Comic, Children's Book, Marvel, USA
Zabrocki, Darek	Illustration, Concept Art, Fantasy, Sci-Fi, Poland
Zadkine, Ossip	Painting, Oil, Cubism, Belarus
Zana, Eytan	Illustration, Concept Art, Game Art, USA
Zener, Eric	Painting, Oil, Portrait, Realism, USA
Zhong, Fenghua	Illustration, China
Zorach, William	Painting, Oil, Watercolor, Portrait, Sculpture, Cubism, Lithuania, USA
Zorn, Anders	Painting, Watercolor, Portrait, Sweden, 19th Century
Zuloaga, Ignacio	Painting, Oil, Portrait, Spain